****~~*******
**^^~~*******
*************
*~*~*~*~*****
*************
*************
*************
*************
*************