****~~*********~~
**^^~~*******~~**
*****************
*~*~*~*~******^^*
*************^***
**************~~*
*****************
*************~~~~
*****************
***^^^****^^^****
***^^^****^^^****
******~~~~*******