****~~*********~~**
**^^~~*******~~****
*******************
*~*~*~*~******^^***
*************^*****
**************~~**^
******************^
*************~~~~*^
******************^
***^^^****^^^*****^
***^^^****^^^****~*
******~~~~*********
*******************
**~~***~~**********